S ./texture/item.xpm

C 75,75,175

NO ./texture/wall_1.xpmmmm

R 1000 000

SO ./texture/waaaall_2.xpm

WE ./texture/wall_3.xpm
WE ./texture/wall_3.xpm

F 50,50,508



EA ./texture/wall_4.xpm

11111111111111111
   0000000000001111
1002001010100011S111
10020011111011000211

   00000000000000021
10100010020000222211
1011111000      111
1010001110111110111
10010000001 0 11 1
    00 001010 0  1
1111111111111111
